Date,Type,Merchant/Description,Debit/Credit,Balance
05/10/2015,ATM Withdrawal NATIONWIDE,ATM Withdrawal NATIONWIDE,-£30.00,"£1,152.43"
05/10/2015,Direct debit SCOPE LTD,SCOPE LTD,-£8.50,"£1,182.43"
03/10/2015,Contactless Payment,FLAT PLANET LONDON W*F GB ****,-£11.00,"£1,190.93"
01/10/2015,Visa purchase,SACAT MARKS & SPENCER PANTHEON GB ****,-£2.86,"£1,201.93"
01/10/2015,Direct debit GREENWICH LEISURE,GREENWICH LEISURE,-£19.95,"£1,204.79"
30/09/2015,Tax taken,*********,-£0.12,"£1,224.74"
30/09/2015,Interest added,Interest added,£0.61,"£1,224.86"
30/09/2015,Visa purchase Graze,Graze Graze.com SE ****,-£3.89,"£1,224.25"